111111111111
10C0000000P1
100000000001
111111111111
10E000000001
111111111111