1111111111111111111111111111111
1E0000000000001C1000C0000000001
1000000000000011100000000000001
1000000000000000000000000000111
100000000C00C0000000000000000P1
1111111111111111111111111111111