111111 111111
10000111000C1
1000011111001
1P0011E000001
1000000000001
1111111111111