1111111111111
 100100000001
1100011111001
1PC011E000001
1111111111111