1111111111
1A00000001
1000000001
1P00000001
1111111111