111111111111111111111111111111111111111111111111111
1P1000000000000000000000000000000000000000000000001
101111110000000000000000000000000000000000000000001
100000000000000000000000000000000000000000000000001
101011100000000000000000000000000000000000000000001
101010000000000000000000000000000000000000000000001
101010000000000000000000000000000000000000000000001
101011100000000000000000000000000000000000000000001
101000000000000000000000000000000000000000000000001
101111100000000000000000000000000000000000000000001
101000000000000000000000000000000000000000000000001
101000000000000000000001111110100000000000000000001
101000000000000000000001E00C10100000000000000000001
101000000000000000000001111010100000000000000000001
101000000000000000000000001010100000000000000000001
101000000000000000000000001010111000000000000000001
101000000000000000000000001000000000000000000000001
100000000000000000000000001111111000000000000000001
100000000000000000000000000000000000000000000000001
100000000000000000000000000000000000000000000000001
100000000000000000000000000000000000000000000000001
100000000000000000000000000000000000000000000000001
100000000000000000000000000000000000000000000000001
100000000000000000000000000000000000000000000000001
100000000000000000000000000000000000000000000000001
100000000000000000000000000000000000000000000000001
10C000000000000000000000000000000000000000000000001
111111111111111111111111111111111111111111111111111