1111111111
101E100001
1010111111
1P00000001
1111111111