1111111111111111111111111111111
1E0000000000000C0000C0000000001
1000000000000000000000000000001
1000000000000000000000000000111
1P0000000C00C0000000000000001P1
1111111111111111111111111111111