1111111111111
 10010000000C 
1000011111001
1PC011E000001
1111111111111