1111111111
1000E000E1
1P000P0C01
1111111111