1111111111
1000E00001
10C0000001
100P0000P1
1111111111