1111111111
1000E000E1
1P00000C01
1111111111